start: 28, 55
55555555555555555555555555555555555555555555555555555555555555555555555555555555555555555555555555555555555555555555555555
56660000000000000000000000000000000000000500000000000000000000000000000000000000000000000000000000000000000000000000000005
56660000000000000000000000000000000000000500000000000000000000000000000000000000000000000000000000000000000000000000000005
56660000000000000000000000000000000000000500000000000000000000000000000000000000000000000000000000000000000000000000000005
56660000000303000000000000000000000000000500000000000000000000000000000000000000000000000000000000000000000000000000000005
56660000003330230000000000000000000000000500000000000000000000000000000000000000000000000000000000000000000000000000000005
56660000033033123000000000000000000000000500000000000000000000000000000000000000000000000000000000000000000000000000000005
56660000003300123000000000000000000000000500000000000000000000000000000000000000000000000000000000000000000000000000000005
56660000000230000000000000000000000000000500000000000000000000000000000000000000000000000000000000000000000000000000000005
56660000000000000000000000000000000000000500000000000000000000000000000000000000000000000000000000000000000000000000000005
56660000000000000000000000000000100000230500000000000000000000000000000000000000000000000000000000000000000000000000000005
56660000000000000000000000000000233333300500000000000000000000000000000000000000000000000000000000000000000000000000000005
56660000000000000000000000000000303003010500000000000000000000000000000000000000000000000000000000000000000000000000000005
56660000000000000000000000000000000000000500000000000000000000000000000000000000000000000000000000000000000000000000000005
56660000000000000000000000000000000000000500000000000000000000000000000000000000000000000000000000000000000000000000000005
56660000000000000000000000000000000000000500000000000000000000000000000000000000000000000000000000000000000000000000000005
56660000000000000000000000000000000000000500000000000000000000000000000000000000000000000000000000000000000000000000000005
56660000000000000000000000000000000000000500000000000000000000000000000000000000000000000000000000000000000000000000000005
56660000000000000000000000000000000000000500000000000000000000000000000000000000000000000000000000000000000000000000000005
50505050505050505050505050500000000000000500000000000000000000000000000000000000000000000000000000000000000000000000000005
55555555555555555555555555550000000000000500000000000000000000000000000000000000000000000000000000000000000000000000000005
50505050505050505050505050500000000000000500000000000000000000000000000000000000000000000000000000000000000000000000000005
50000000000000000000000000000000000000000500000000000000000000000000000000000000000000000000000000000000000000000000000005
50000000000000000000000000321000000000000500000000000000000000000000000000000000000000000000000000000000000000000000000005
50000000000000000000000000030000000000000500000000000000000000000000000000000000000000000000000000000000000000000000000005
50000000000000000000000000333000000000000500000000000000000000000000000000000000000000000000000000000000000000000000000005
50000000000000000000000003033200000000000500000000000000000000000000000000000000000000000000000000000000000000000000000005
50000000000000000000000000210000000000000500000000000000000000000000000000000000000000000000000000000000000000000000000005
50000000000000000000000000000000000000000500000000000000000000000000000000000000000000000000000000000000000000000000000005
50000000000000000000000000003000000000000500000000000000000000000000000000000000000000000000000000000000000000000000000005
50000000000000000000000000033300000000000500000000000000000000000000000000000000000000000000000000000000000000000000000005
50000000000000000000000000003000000000000500000000000000000000000000000000000000000000000000000000000000000000000000000005
50000000000000000000000000000000000000000500000000000000000000000000000000000000000000000000000000000000000000000000000005
50000000000000000000000000000000000000000500000000000000000000000000000000000000000000000000000000000000000000000000000005
50000000000000000000000000321000000000000500000000000000000000000000000000000000000000000000000000000000000000000000000005
50000000000000000000000000030000000000000500000000000000000000000000000000000000000000000000000000000000000000000000000005
50000000000000000000000000333000000000000500000000000000000000000000000000000000000000000000000000000000000000000000000005
50000000000000000000000003033200000000000500000000000000000000000000000000000000000000000000000000000000000000000000000005
50000000000000000000000000210000000000000500000000000000000000000000000000000000000000000000000000000000000000000000000005
50000000000000000000000000000000000000000500000000000000000000000000000000000000000000000000000000000000000000000000000005
50000000000050505050505050505050505050505500000000000000000000000000000000000000000000000000000000000000000000000000000005
50000000000555555555555555555555555555555500000000000000000000000000000000000000000000000000000000000000000000000000000005
50000000000050505050505050505050505050505500000000000000000000000000000000000000000000000000000000000000000000000000000005
50000000000000000000000000000000000000000000000000000000000000000000000000000000000000000000000000000000000000000000000005
50000000000000000000000000000000000000000000000000000000000000000000000000000000000000000000000000000000000000000000000005
50000000000000000000000000000000000000000000000000000000000000000000000000000000000000000000000000000000000000000000000005
50000000303000000000000000000000000000000000000000000000000000000000000000000000000000000000000000000000000000000000000005
50000003330230000000000000000000030000000000000000000000000000000000000000000000000000000000000000000000000000000000000005
50000033033123000000000000000000333000000000000000000000000000000000000000000000000000000000000000000000000000000000000005
50000003300123000000000000000000030000000000000000000000000000000000000000000000000000000000000000000000000000000000000005
50000000230000000000000000000000000000000000000000000000000000000000000000000000000000000000000000000000000000000000000005
50000000000000000000000000000000000000000000000000000000000000000000000000000000000000000000000000000000000000000000000005
50000000000000000000000000000000000000000000000000000000000000000000000000000000000000000000000000000000000000000000000005
50000000000000000000000000000000000000000000000000000000000000000000000000000000000000000000000000000000000000000000000005
50000000000000000000000000000000000000000000000000000000000000000000000000000000000000000000000000000000000000000000000005
50000000000000000000000000000000000000000000000000000000000000000000000000000000000000000000000000000000000000000000000005
50000000000000000000000000000000000000000000000000000000000000000000000000000000000000000000000000000000000000000000000005
50000000000000000000000000000000000000000000000000000000000000000000000000000000000000000000000000000000000000000000000005
55555555555555555555555555555555555555555555555555555555555555555555555555555555555555555555555555555555555555555555555555
